

1111111
11111
1111111

&&&




