111111111111111111111
1C000000P0000011110C1
10E0000001C1100CC1001
10C00C00C1C111C000CC1
10C00000C0000C0011C01
11C1CCCCCCC00011110C1
111111111111111111111